##############################
#............................#
#............................#
#............................#
=............................#
#............................#
#............................#
#............................#
#............................#
#............................#
##############################