##############################
#............................#
#............................#
#............................#
#............................=
#......c.....................#
#..c.........................#
#....c.......................#
#............................#
#............................#
##############################